
Wokeuplikerick

James Brown - Sex Machine (Live at Studio 54)
The Chemical Brothers - Block Rockin Beats
Wu-Tang Clan - Wu-Tang: 7th Chamber
Semisonic - Closing Time
J Dilla - Workinonit
Slick Rick - La Di Da Di
Radiohead - Creep (Acoustic)
Black Sabbath - War Pigs

Rockism

Radiohead - Pulk/Pull Revolving Doors
Boards of Canada - An Eagle In Your Mind
Post Malone - Rockstar
Clipse - Grindin'
MOP - Ante Up
Rick Astley - Never Gonna Give You Up
Beenie Man - Girls Dem Sugar
Blink-182 - The Rock Show
Gorillaz - Clint Eastwood

Party's Over

Darude - Sandstorm
Lil Pump - Gucci Gang
Prince - 1999
Gorillaz - Dare
DJ Mujava - Township Funk
Disturbed - Down With The Sickness

One Night Enemy Stand

The Clash - Train in Vain
Kesha - Tik Tok
Soulja Boy - Pretty Boy Swag
Daft Punk - Aerodynamic
Pantha du Prince - The Splendour
Reel 2 Real - I Like to Move It
The Prodigy - Hyperspeed (G-Force Part 2)

The Plot Thickens

Outkast - SpottieOttieDopaliscious
Destiny's Child - Say My Name
Bob Marley - Is This Love
Backstreet Boys - Everybody (Backstreet's Back)

Building Genders

DJ Shadow - Building Steam with a Grain of Salt
Cam'ron - Oh Boy
Jay-Z - Girls, Girls, Girls

Charmed, I'm Sure

Public Enemy - 911 is a Joke
The Smiths - This Charming Man
SOPHIE - Lemonade
Busta Rhymes - Touch It
The Notorious BIG - Mo Money Mo Problems
The Offspring - Self-Esteem
Wu-Tang Clan - Da Mystery of Chessboxin
Los del Rio - Macarena
Smash Mouth - All Star

Chase Your Nightmares

Metallica - One
Blueface - Dead Locs
Cypress Hill - Insane In The Brain
Justice - Valentine

Tease and Denial

Childisn Gambino - Redbone
Lil' Wayne and Birdman - Stunnin Like My Daddy
Nobuo Uematsu - Prelude to Final Fantasy VII
Jai Paul - Str8 Outta Mumbai
Big Sean - Dance (ASS)
Lenny Kravitz - Fly Away
Rae Sremmurd - Black Beatles
Death Grips - The Fever (Aye Aye)

Star-Lord

Sean Paul - Gimme the Light
Beastie Boys - Intergalactic
The Five Stairsteps - O-o-h Child
Redbone - Come and Get Your Love
Queen - We Will Rock You
House of Pain - Jump Around
Lil Jon & The East Side Boyz - Get Low
Daft Punk - Veridis Quo

Cross Faded

Black Sabbath - Sweet Leaf
Young Thug - Stoner
Beyoncé - Drunk in Love
Nine Inch Nails - 34 Ghosts IV
Rustie - Hover Traps

J&M

Pearl Jam - Yellow Ledbetter
Mariah Carey - We Belong Together
Janet Jackson - Love Will Never Do (Without You)
Joy Orbison - Hyph Mngo
Ludacris - Southern Hospitality
Benga & Coki - Night

Boy Problems

Bicep - Opal
Craig David - Fill Me In
Armand van Helden - You Don't Know Me
Mr. Oizo - Flat Beat
Katy Perry - Dark Horse

WWW (Edit)

Ross From Friends - Talk to Me You'll Understand
Oasis - Wonderwall
Rihanna - Work
Little Richard - Tutti Frutti
Faboy Slim - The Rockafeller Skank

Nevertheless

Swae Lee & Post Malone - Sunflower
Mitski - Two Slow Dancers
Nelly - EI
A-ha - Take On Me
Daddy Yankee - Rompé (Remix)
311 - Down
G-Eazy - No Limt
Electric Six - Gay Bar

Affair of the Diamond Necklace

Kreayshawn - Gucci Gucci
Aphex Twin - Avril 14th
The Weeknd - The Hills
Ashanti - Only U
Travis Scott - Sicko Mode
Ying Yang Twins - Wait (The Whisper Song)

Carpal Tunnel

The Prodigy - No Good (Start The Dance)
American Football - Never Meant
Outkast - Hey Ya!
Lil Uzi Vert - New Patek
Migos - Bad & Boujee
Yuki Hayashi - Death Parade
Loefah - Disko Rekah
Kendrick Lamar - Swimming Pools (Drank)
Weezer - Only in Dreams
Foo Fighters - Everlong